ad - name - no hint
Senin adın - your name - no hint
Senin adın ne - what's your name - no hint
gün - ??? - no hint
güneşli bir gün - a sunny day - no hint
güneşli bir gün - it's a sunny day - no hint
bir - 1 - no hint
sadece bir gece - just one night - no hint
sadece bir gece kalıyoruz - we're staying just one night - no hint
zaman - time - no hint
ne zaman - what time - no hint
ne zaman döner - what time does he return - no hint
yön - way - no hint
O yöne - that way - no hint
O yöne gitti - he went that way - no hint
yıl - year - no hint
gelecek yok - next year - no hint
Gelecek yıl geri geliyorum - I'm coming back next year - no hint
bugün - today - no hint
bugün de - today is well - no hint
Bugün de güneşli olacak - today will be sunny as well - no hint
??? - yesterday - no hint
dün sabah - yesterday morning - no hint
Dün sabah geldik - we came yesterday morning - no hint
yarın - tomorrow - no hint
yarına yemek - dinner for tomorrow - no hint
yarına yemek yapacağım - I'll cook dinner for tomorrow - no hint
kendi - self - no hint
kendine hakim olmak - self control - no hint
kendine hakim olmak zor - self-control is hard - no hint
yer - ground - no hint
yere düşer - falls on the ground - no hint
bebek yere düşer - the baby falls on the ground - no hint
insan - human - no hint
insan evrimi - human evolution - no hint
binlerce yıldır insan evrimi devam eder - human evolution continues on for thousands of years - no hint
