o - key - no hint
onun yiyeceği yemek - the food he is going to eat - no hint
onun yiyeceği yemek hazır - the food he is going to eat is ready - no hint
buraya - hear - no hint
buraya ne zaman - when here - no hint
Buraya ne zaman geleceksin - when will you come here - no hint
ben - I - no hint
ben olmasam - if I don't exist - no hint
Ben olmasam daha mutlu olursun - you will be happier if I don't exist - no hint
o - it - no hint
onu yere düşürmek - dropping it on the ground - no hint
onu yere düşürmek kolay - dropping it on the ground is easy - no hint
o - she - no hint
ona yalan söylemek - lying to her - no hint
ona yalan söylemek en kötüsü - lying to her is the worst - no hint
şu - that - no hint
şunu açıklamadan - without explaining that - no hint
şunu açıklamadan hiçbir yere gidemez - he can't go anywhere without explaining that - no hint
oraya - there - no hint
şimdi oraya - now there - no hint
ver - now - no hint
o gözlerine yav - shim deoria - no hint
iyiyiz - send it - no hint
the box - ??? - no hint
box braid - Boomerang Catoosa - no hint
Way - will not include stock in Amazon - no hint
evde yorgan - Omar - no hint
evde yorgan Ayşegül Yavuz bayağı - ??? - no hint
West - Omar Getty - no hint
pendis - ??? - no hint
Viking pendis - Adam Adam - no hint
Bey - Amazon - no hint
lütfen - ??? - no hint
oyun tableti - ??? - no hint
i - will not get it done - no hint
beni vur beni i - ??? - no hint
??? - biscuit origin - no hint
you - bizcocho - no hint
even if you can come - ??? - no hint
mobil fine-grained videom Kaan - ??? - no hint
et - San Jose - no hint
to understand - ??? - no hint
110 - UNO online - no hint
ay - ??? - no hint
I'm Just - ??? - no hint
I'm just a poor Man - ??? - no hint
