sadece - just - no hint
evin içine - into the house - no hint
bir bardak kırmızı veya beyaz şarap içer misin - will you drink a glass of red or white wine - no hint
bazen ilaç almak tehlikelidir - taking medicine is dangerous sometimes - no hint
Senin adın - your name - no hint
gerçekten var - really exist - no hint
demek - to say - no hint
değil - not - no hint
kadar - until - no hint
okyanusun yakınında - by the ocean - no hint
sabaha kadar - until morning - no hint
gece dışarı çıkmak iyi bir şey değil - it's not a good thing to go out at night - no hint
bu hediye anne ve baba niçin - this present is for your parents - no hint
ve - and - no hint
Hiçbir kitap - no book - no hint
bir - one - no hint
hava güneşli olduğu zaman mutluyum - I'm happy when it's sunny - no hint
nerede olursa olsun onu mutlaka bulacağım - no matter where he is I'll definitely find him - no hint
nerede olursa olsun - no matter where he is - no hint
gün - day - no hint
evin içinde - in the house - no hint
ilaç almak - taking medicine - no hint
yarın yapılacak çok şey yok - there aren't many things to be done tomorrow - no hint
hiç anlayamıyorum - cannot understand at all - no hint
sadece bir gece - just one night - no hint
lütfen öğleden önce gel - please come before noon - no hint
o dünyadaki en güzel şehir - it's the most beautiful city in the world - no hint
Hayaletler gerçekten var - ghosts really exist - no hint
sadece bir gece kalıyoruz - we're staying just one night - no hint
bunu kimden duydun - who did you hear this from - no hint
köpek evin içinde koşuyor - the dog is running into the house - no hint
gitmek - go - no hint
ekmek masanın üstünde - the bread is on the table - no hint
o yöne - that way - no hint
sık sık balık avlamaya - Austin fishing - no hint
gerçekten - really - no hint
sevdiğimi son bir kez yakından göreyim - let me see my beloved up close for the last time - no hint
bakmak ve görmek farklı şeylerdir - looking and seeing are different things - no hint
binlerce yıldır insan evrimi devam eder - human evolution continues on for thousands of years - no hint
yeni bir saat - a new watch - no hint
olmak - be - no hint
eğer gidersen - if you go - no hint
almak - take - no hint
yıl - year - no hint
ama pasta sevmem - but I don't like cake - no hint
dükkana gidiyor - is going to the store - no hint
yere düşer - falls on the ground - no hint
Bu nedir - what is it - no hint
yakından göreyim - let me see up close - no hint
nerede - where - no hint
benim - my - no hint
bakmak ve görmek - looking and seeing - no hint
kırmızı kalem istiyoruz mavi değil - we want red pencils not blue - no hint
ofise geliyor - is coming to the office - no hint
kendine hakim olmak - self control - no hint
çikolatayı severim ama pasta sevmem - I like chocolate but I don't like cake - no hint
kadın cumartesi günü çalışmak zorunda - the woman has to work on Saturday - no hint
oraya nasıl gidilir - how did you get there - no hint
büyük koltuk - big sofa - no hint
onu sever - loves - no hint
sıcak görünüyor - looks hot - no hint
kahvaltı istiyorlar - they want breakfast - no hint
görünmek - look - no hint
ama - but - no hint
bu kötü haber - this is bad news - no hint
bu hediye benim mi - is this present mine - no hint
güneşli bir gün - it's a sunny day - no hint
eğer - if - no hint
Güneşli olduğu zaman - when it's sunny - no hint
ad - name - no hint
bu kazak küçük boy - the sweater is small size - no hint
tenisten hoşlanır mısın - do you like tennis - no hint
insan evrimi - human evolution - no hint
en utandırıcı - most embarrassing - no hint
Hiçbir kitap çöpe atılmamalı - no book should be thrown away - no hint
içine - into - no hint
iyi bir arkadaş - a good friend - no hint
herhangi - any - no hint
çıkmak - go out - no hint
onun - her - no hint
çok karanlık - very dark - no hint
en güzel - most beautiful - no hint
onların kızı - their daughter - no hint
yarına yemek yapacağım - I'll cook dinner for tomorrow - no hint
daha - more - no hint
gerçekten soğuk - really cold - no hint
sonra - after - no hint
çok - many - no hint
Araba sahibi değilsin - don't have a nice car - no hint
belki - Maybe - no hint
dükkan saat altıdan sonra kapanır - the store is closed after 6 - no hint
masanın üstünde - on the table - no hint
hangi kitabı okudun - which book did you read - no hint
her duyduğunu tekrar etmek iyi bir şey değildir - it's not a good thing to repeat everything you hear - no hint
gözlük takıyorum Çünkü gözlerim bozuk - I'm wearing glasses because my eyes are bad - no hint
Her şey sadece istemekle olmaz - not everything can be done with just wanting - no hint
içmek - drink - no hint
sık sık balık avlamaya çıkarım - I often go fishing - no hint
küçük - small - no hint
sahip olmak - own - no hint
kendin hakkında - about yourself - no hint
çok şey - many things - no hint
çalışmak - work - no hint
gibi - like - no hint
yeni - new - no hint
dener şeyler - things said - no hint
abim ve ablam - my older brother and sister - no hint
elmalı pie krema ile servis edilir - apple pie served with cream - no hint
ne zaman döner - what time does he return - no hint
duymak - to hear - no hint
daha güzel - more beautiful - no hint
Benim İlk günüm - my first day - no hint
bugün dışarısı sıcak görünüyor - it looks hot outside today - no hint
ne - what - no hint
tenisten hoşlanır - likes tennis - no hint
yemek yapar - makes food - no hint
yukarı çıkıyor - is going up - no hint
sadece bir gece - just one night - no hint
Senin adın ne - what's your name - no hint
iyi oynuyor - is playing well - no hint
bizim - our - no hint
o iyi bir arkadaş - she's a good friend - no hint
Onun telefonu - her phone - no hint
hoşlanmak - like - no hint
çünkü - because - no hint
ve - and - no hint
dün sabah geldik - we came yesterday morning - no hint
ile - with - no hint
üç bilet satın aldım - I got three tickets - no hint
gelecek yıl geri geliyorum - I'm coming back next year - no hint
belki yağmur yağar - maybe it will rain - no hint
bu ve şu - this and that - no hint
nasıl gidilir - how to go - no hint
veriyorsun - are giving - no hint
içi - in - no hint
senin - your - no hint
Onun telefonu yine - her phone is new - no hint
daha iyi olur - it's better - no hint
o - key - no hint
kendi - self - no hint
kendin hakkında bahset - tell me about yourself - no hint
en - most - no hint
ile - with - no hint
ipek gibi - like Silk - no hint
