bu kötü haber - this is bad news - no hint
her kış - every winter - no hint
herhangi bir kız olabilir - she could be any girl - no hint
Bu benim değil - it's not mine - no hint
sonra - after - no hint
en utandırıcı - most embarrassing - no hint
daha güzel - more beautiful - no hint
yeni bir saat istiyorum - I want a new watch - no hint
sabaha kadar - until morning - no hint
hangi kitabı - which book - no hint
bu hediye - this present - no hint
istemek - want - no hint
gerçekten soğuk - really cold - no hint
ama - but - no hint
onun - his - no hint
sabaha kadar vaktim var - I have time until morning - no hint
dükkana gidiyor - she is going to the store - no hint
kim - whom - no hint
bakmak ve görmek - looking and seeing - no hint
kendin hakkında bahset - tell me about yourself - no hint
hoşlanmak - like - no hint
gece dışarı çıkmak - go out at night - no hint
bu ve şu lütfen - listen that please - no hint
nedir - what is - no hint
abim ve ablam - my older brother and sister - no hint
gece dışarı çıkmak iyi bir şey değil - it's not a good thing to go out at night - no hint
tüm dükkanlar - all shops - no hint
sadece bir gece - just one night - no hint
önce - before - no hint
takım iyi oynuyor - the team is playing well - no hint
hangi - which - no hint
içmek - drink - no hint
randevunuzu ne zaman almak istersiniz - when would you like to schedule your appointment - no hint
söylemek - say - no hint
eğer gidersen ben de giderim - if you go I'll go - no hint
yarına yemek yapacağım - I'll cook dinner for tomorrow - no hint
çikolatayı severim ama pasta sevmem - I like chocolate but I don't like cake - no hint
ad - name - no hint
asansör yukarı çıkıyor - the elevator is going up - no hint
büyük - big - no hint
bu hediye benim mi - is this present mine - no hint
bugün de güneşli olacak - today will be sunny as well - no hint
sadece - just - no hint
bu gece çok karanlık - it's very dark tonight - no hint
altı - under - no hint
çünkü - because - no hint
çok - many - no hint
Akşam yemeğinden sonra - after dinner - no hint
veya - or - no hint
zaman - time - no hint
iyi bir arkadaş - a good friend - no hint
kendin hakkında - about yourself - no hint
bebek yere düşer - the baby falls on the ground - no hint
iyi bir araba sahibi değilsin - you don't have a nice car - no hint
üstü - on - no hint
krema ile - with cream - no hint
Çünkü gözlerim bozuk - because my eyes are bad - no hint
binlerce yıldır insan evrimi devam eder - human evolution continues on for thousands of years - no hint
Onun telefonu - her phone - no hint
kırmızı kalem istiyoruz mavi değil - we want red pencils not blue - no hint
tüm dükkanlar şimdi kapalı - all the shops are closed now - no hint
görmek - to see - no hint
veriyorsun - are giving - no hint
Benim evim ırmağa yakın - my house is near the river - no hint
gelecek yok - next year - no hint
iyi - well - no hint
bu ev daha güzel - this house is more beautiful - no hint
gözlük takıyorum Çünkü gözlerim bozuk - I'm wearing glasses because my eyes are bad - no hint
iyi - good - no hint
gelecek yıl geri geliyorum - I'm coming back next year - no hint
dükkan saat altıdan sonra kapanır - the store is closed after 6 - no hint
kötü haber - bad news - no hint
sevmek - love - no hint
bir - one - no hint
olmak - to be - no hint
para vermek - giving money - no hint
çok şey - many things - no hint
burada benim ilk günüm - it's my first day here - no hint
en - most - no hint
gün - day - no hint
yeni bir saat - a new watch - no hint
her sabah kahve içerim - I drink coffee every morning - no hint
her kış kayak yapmaya giderler - they go skiing every winter - no hint
Kız kardeşim evin içinde - my sister is in the house - no hint
Benim İlk günüm - my first day - no hint
herhangi - any - no hint
sadece bir gece kalıyoruz - we're staying just one night - no hint
nerede olursa olsun onu mutlaka bulacağım - no matter where he is I'll definitely find him - no hint
neden - why - no hint
kadar - until - no hint
o yöne gitti - he went that way - no hint
olmak - be - no hint
bilmek - know - no hint
yapmak - make - no hint
kahvaltı istiyorlar - they want breakfast - no hint
Hiçbir kitap çöpe atılmamalı - no book should be thrown away - no hint
onun çantası - his bag - no hint
senin - your - no hint
mutfakta yiyoruz - are eating in the kitchen - no hint
benim - my - no hint
satın almak - buy - no hint
bazen ilaç almak tehlikelidir - taking medicine is dangerous sometimes - no hint
vermek - give - no hint
yukarı - up - no hint
